Fylkenummer;Fylkenavn;Kommunenummer;Kommunenavn;Stemmekretsnummer;Stemmekretsnavn;Antall stemmeberettigede;Godkjente stemmegivninger — Forhånd;Godkjente stemmegivninger - Valgting;Godkjente stemmegivninger - Totalt;Forkastede stemmegivninger - Forhånd;Forkastede stemmegivninger - Totalt;Godkjente stemmesedler - Forhånd;Godkjente stemmesedler - Valgting;Godkjente stemmesedler - Totalt;Forkastede stemmesedler - Forhånd;Forkastede stemmesedler - Totalt;Blanke stemmesedler - Forhånd;Blanke stemmesedler - Totalt;
01;Østfold;0101;Halden;0000;Hele kommunen;22632;2658;14144;16802;3;44;2665;14160;16825;16;31;10;107;
01;Østfold;0104;Moss;0000;Hele kommunen;22764;3748;13624;17372;0;35;3739;13625;17364;15;19;18;91;
01;Østfold;0105;Sarpsborg;0000;Hele kommunen;39631;5851;23411;29262;4;21;5843;23419;29262;33;71;26;172;
01;Østfold;0106;Fredrikstad;0000;Hele kommunen;57134;19076;24199;43275;2;15;19076;24123;43199;2;47;87;240;
01;Østfold;0111;Hvaler;0000;Hele kommunen;3419;707;2066;2773;1;1;706;2067;2773;3;7;2;5;
01;Østfold;0118;Aremark;0000;Hele kommunen;1116;133;792;925;0;0;133;790;923;0;0;2;5;
01;Østfold;0119;Marker;0000;Hele kommunen;2794;435;1766;2201;3;3;434;1763;2197;0;0;3;15;
01;Østfold;0121;Rømskog;0000;Hele kommunen;526;87;356;443;0;0;86;356;442;1;1;1;5;
01;Østfold;0122;Trøgstad;0000;Hele kommunen;3947;643;2364;3007;1;1;643;2370;3013;0;3;6;22;
01;Østfold;0123;Spydeberg;0000;Hele kommunen;4039;695;2519;3214;0;2;698;2521;3219;0;0;3;10;
01;Østfold;0124;Askim;0000;Hele kommunen;11150;2436;5808;8244;0;4;2434;5808;8242;5;5;11;69;
01;Østfold;0125;Eidsberg;0000;Hele kommunen;8130;1370;4616;5986;0;25;1369;4617;5986;2;2;12;41;
01;Østfold;0127;Skiptvet;0000;Hele kommunen;2627;470;1549;2019;0;0;469;1549;2018;0;0;1;12;
01;Østfold;0128;Rakkestad;0000;Hele kommunen;5828;624;3652;4276;1;4;620;3647;4267;4;5;1;14;
01;Østfold;0135;Råde;0000;Hele kommunen;5227;708;3571;4279;4;8;708;3570;4278;1;6;4;23;
01;Østfold;0136;Rygge;0000;Hele kommunen;11076;1917;6697;8614;0;5;1911;6698;8609;11;16;4;42;
01;Østfold;0137;Våler;0000;Hele kommunen;3429;360;2336;2696;0;0;362;2326;2688;0;0;0;12;
01;Østfold;0138;Hobøl;0000;Hele kommunen;3569;479;2351;2830;0;0;478;2374;2852;0;0;1;10;
02;Akershus;0211;Vestby;0000;Hele kommunen;10889;1985;6934;8919;0;27;1986;6949;8935;6;22;6;36;
02;Akershus;0213;Ski;0000;Hele kommunen;20523;3829;13122;16951;3;39;3835;13131;16966;5;15;11;54;
02;Akershus;0214;Ås;0000;Hele kommunen;11791;2307;7367;9674;0;44;2307;7368;9675;4;9;17;50;
02;Akershus;0215;Frogn;0000;Hele kommunen;11293;3186;6388;9574;11;20;3190;6390;9580;20;31;10;36;
02;Akershus;0216;Nesodden;0000;Hele kommunen;12595;3906;6692;10598;2;12;3908;6698;10606;4;10;10;41;
02;Akershus;0217;Oppegård;0000;Hele kommunen;18625;3939;12130;16069;2;14;3932;12138;16070;17;18;15;55;
02;Akershus;0219;Bærum;0000;Hele kommunen;79277;21471;45904;67375;26;109;21483;45960;67443;59;130;71;192;
02;Akershus;0220;Asker;0000;Hele kommunen;38963;10660;22373;33033;19;57;10659;22377;33036;3;14;43;104;
02;Akershus;0221;Aurskog-Høland;0000;Hele kommunen;11197;1503;7381;8884;1;1;1503;7356;8859;8;9;17;52;
02;Akershus;0226;Sørum;0000;Hele kommunen;11191;1645;7583;9228;0;0;1640;7590;9230;11;15;11;51;
02;Akershus;0227;Fet;0000;Hele kommunen;7718;1262;5099;6361;1;6;1260;5099;6359;3;5;2;18;
02;Akershus;0228;Rælingen;0000;Hele kommunen;11654;2243;6866;9109;1;17;2246;6872;9118;6;10;10;38;
02;Akershus;0229;Enebakk;0000;Hele kommunen;7348;976;4789;5765;2;25;984;4809;5793;3;6;5;32;
02;Akershus;0230;Lørenskog;0000;Hele kommunen;24027;4134;14857;18991;5;34;4133;14863;18996;15;27;11;77;
02;Akershus;0231;Skedsmo;0000;Hele kommunen;35670;7847;19955;27802;6;21;7859;20001;27860;1;23;20;93;
02;Akershus;0233;Nittedal;0000;Hele kommunen;15334;2764;9940;12704;0;6;2768;9936;12704;2;23;11;49;
02;Akershus;0234;Gjerdrum;0000;Hele kommunen;4226;708;2811;3519;3;3;707;2814;3521;0;0;2;14;
02;Akershus;0235;Ullensaker;0000;Hele kommunen;21589;3665;13043;16708;2;21;3672;13060;16732;3;13;19;91;
02;Akershus;0236;Nes;0000;Hele kommunen;14567;2298;8901;11199;0;8;2293;8902;11195;5;13;9;63;
02;Akershus;0237;Eidsvoll;0000;Hele kommunen;16034;2150;10074;12224;2;44;2153;10088;12241;5;19;9;75;
02;Akershus;0238;Nannestad;0000;Hele kommunen;7935;1193;4869;6062;1;9;1196;4870;6066;3;18;7;35;
02;Akershus;0239;Hurdal;0000;Hele kommunen;1993;430;1092;1522;0;0;431;1100;1531;2;6;0;11;
03;Oslo;0301;Oslo;0000;Uoppgitt krets;12571;135439;52;135491;106;335;135234;52;135286;33;33;453;453;
03;Oslo;0301;Oslo;0101;Vahl skole;4190;0;1615;1615;0;0;0;1615;1615;0;0;0;9;
03;Oslo;0301;Oslo;0102;Tøyen skole;5185;0;2583;2583;0;0;0;2584;2584;0;0;0;17;
03;Oslo;0301;Oslo;0103;Kampen skole;3514;0;2013;2013;0;0;0;2015;2015;0;1;0;9;
03;Oslo;0301;Oslo;0104;Gamlebyen skole;6526;0;2285;2285;0;0;0;2287;2287;0;0;0;14;
03;Oslo;0301;Oslo;0105;Jordal skole;2209;0;1245;1245;0;0;0;1245;1245;0;0;0;4;
03;Oslo;0301;Oslo;0106;Vålerenga skole;3749;0;1676;1676;0;0;0;1677;1677;0;0;0;5;
03;Oslo;0301;Oslo;0107;Etterstad videregående skole;3108;0;1756;1756;0;0;0;1758;1758;0;0;0;5;
03;Oslo;0301;Oslo;0108;Fyrstikkalleen skole;3269;0;1514;1514;0;0;0;1515;1515;0;2;0;4;
03;Oslo;0301;Oslo;0201;Hasle skole;3846;0;2378;2378;0;0;0;2378;2378;0;1;0;10;
03;Oslo;0301;Oslo;0202;Sinsen skole;8238;0;3244;3244;0;0;0;3247;3247;0;1;0;16;
03;Oslo;0301;Oslo;0203;Engelsborg ressurssenter;7997;0;3345;3345;0;0;0;3345;3345;0;0;0;16;
03;Oslo;0301;Oslo;0204;Grünerløkka skole;4364;0;2566;2566;0;0;0;2568;2568;0;0;0;9;
03;Oslo;0301;Oslo;0205;Foss videregående skole;4454;0;2062;2062;0;0;0;2063;2063;0;0;0;13;
03;Oslo;0301;Oslo;0206;Anker Hotel;5980;0;2169;2169;0;0;0;2187;2187;0;0;0;16;
03;Oslo;0301;Oslo;0301;Sagene samfunnshus;4709;0;2453;2453;0;0;0;2455;2455;0;0;0;13;
03;Oslo;0301;Oslo;0302;Bjølsen skole;4241;0;1998;1998;0;0;0;1998;1998;0;0;0;10;
03;Oslo;0301;Oslo;0303;Nordpolen skole;4289;0;2061;2061;0;0;0;2062;2062;0;0;0;10;
03;Oslo;0301;Oslo;0304;Lilleborg skole;4261;0;2143;2143;0;0;0;2144;2144;0;0;0;5;
03;Oslo;0301;Oslo;0305;Sagene festivitetshus;5758;0;1880;1880;0;0;0;1880;1880;0;1;0;10;
03;Oslo;0301;Oslo;0306;Grefsenveien 28, selskapslokale;4879;0;2003;2003;0;0;0;2004;2004;0;0;0;4;
03;Oslo;0301;Oslo;0401;Marienlyst skole;1226;0;686;686;0;0;0;686;686;0;0;0;5;
03;Oslo;0301;Oslo;0402;Fagerborg videregående skole;4245;0;2245;2245;0;0;0;2245;2245;0;0;0;13;
03;Oslo;0301;Oslo;0403;Bolteløkka skole;5756;0;2918;2918;0;0;0;2917;2917;0;1;0;13;
03;Oslo;0301;Oslo;0404;Ila skole;5096;0;2178;2178;0;0;0;2180;2180;0;0;0;15;
03;Oslo;0301;Oslo;0405;Oslo katedralskole;6300;0;2790;2790;0;0;0;2789;2789;0;1;0;12;
03;Oslo;0301;Oslo;0406;Møllergata skole;2387;0;1158;1158;0;0;0;1159;1159;0;0;0;10;
03;Oslo;0301;Oslo;0501;Politihøgskolen;5807;0;2469;2469;0;0;0;2471;2471;0;0;0;9;
03;Oslo;0301;Oslo;0502;Paviljongen, Bogstadveien 76;3795;0;1749;1749;0;0;0;1751;1751;0;1;0;11;
03;Oslo;0301;Oslo;0503;Kristelig Gymnasium;4818;0;1986;1986;0;0;0;1986;1986;0;1;0;8;
03;Oslo;0301;Oslo;0504;Uranienborg menighetshus;2906;0;1228;1228;0;0;0;1229;1229;0;0;0;5;
03;Oslo;0301;Oslo;0505;Uranienborg skole;3671;0;2334;2334;0;0;0;2335;2335;0;0;0;3;
03;Oslo;0301;Oslo;0506;Frogner menighetshus Schafteløkken;3134;0;1541;1541;0;0;0;1543;1543;0;0;0;5;
03;Oslo;0301;Oslo;0507;Frogner kino;2878;0;1984;1984;0;0;0;1985;1985;0;1;0;9;
03;Oslo;0301;Oslo;0508;Oslo handelsgymnasium;6348;0;2872;2872;0;0;0;2876;2876;0;0;0;11;
03;Oslo;0301;Oslo;0509;Ruseløkka skole;2129;0;950;950;0;0;0;949;949;0;0;0;5;
03;Oslo;0301;Oslo;0510;Bygdøy skole;2357;0;1520;1520;0;0;0;1522;1522;0;0;0;2;
03;Oslo;0301;Oslo;0601;Lysejordet skole;3595;0;1864;1864;0;0;0;1864;1864;0;2;0;5;
03;Oslo;0301;Oslo;0602;Øraker skole;4531;0;2241;2241;0;0;0;2243;2243;0;0;0;7;
03;Oslo;0301;Oslo;0603;Bestum skole;3514;0;1954;1954;0;0;0;1955;1955;0;0;0;3;
03;Oslo;0301;Oslo;0604;Njårdhallen;2763;0;1042;1042;0;0;0;1089;1089;0;0;0;3;
03;Oslo;0301;Oslo;0605;Smestad skole;2895;0;1758;1758;0;0;0;1758;1758;0;0;0;3;
03;Oslo;0301;Oslo;0606;Skøyen skole;4260;0;2355;2355;0;0;0;2357;2357;0;2;0;2;
03;Oslo;0301;Oslo;0701;Vinderen skole;2501;0;1486;1486;0;0;0;1487;1487;0;0;0;4;
03;Oslo;0301;Oslo;0702;Ris ungdomsskole;2536;0;1300;1300;0;0;0;1300;1300;0;0;0;3;
03;Oslo;0301;Oslo;0703;Slemdal skole;3951;0;2428;2428;0;0;0;2431;2431;0;0;0;4;
03;Oslo;0301;Oslo;0704;Svendstuen skole;4617;0;2231;2231;0;0;0;2232;2232;0;1;0;4;
03;Oslo;0301;Oslo;0705;Grindbakken skole;3353;0;1637;1637;0;0;0;1639;1639;0;0;0;2;
03;Oslo;0301;Oslo;0706;Bogstad skole;3217;0;1455;1455;0;0;0;1456;1456;0;1;0;2;
03;Oslo;0301;Oslo;0707;Huseby skole;3143;0;1447;1447;0;0;0;1449;1449;0;0;0;1;
03;Oslo;0301;Oslo;0708;Hovseter skole;4207;0;2071;2071;0;0;0;2071;2071;0;1;0;4;
03;Oslo;0301;Oslo;0709;Persbråten videregående skole;3049;0;1701;1701;0;0;0;1703;1703;0;4;0;4;
03;Oslo;0301;Oslo;0801;Ullevål skole;3804;0;2553;2553;0;0;0;2574;2574;0;0;0;8;
03;Oslo;0301;Oslo;0802;Sogn videregående skole;2473;0;20;20;0;0;0;0;0;0;0;0;0;
03;Oslo;0301;Oslo;0803;Kringsjå skole;2245;0;1763;1763;0;0;0;1763;1763;0;1;0;4;
03;Oslo;0301;Oslo;0804;Korsvoll skole;3351;0;2112;2112;0;0;0;2113;2113;0;0;0;3;
03;Oslo;0301;Oslo;0805;Tåsen skole;4490;0;3368;3368;0;0;0;3371;3371;0;2;0;8;
03;Oslo;0301;Oslo;0806;Kjelsås skole;4042;0;2610;2610;0;0;0;2610;2610;0;1;0;7;
03;Oslo;0301;Oslo;0807;Engebråten skole;2205;0;1499;1499;0;0;0;1501;1501;0;0;0;7;
03;Oslo;0301;Oslo;0808;Morellbakken skole;4826;0;2012;2012;0;0;0;2015;2015;0;0;0;3;
03;Oslo;0301;Oslo;0809;Disen skole;2815;0;1719;1719;0;0;0;1722;1722;0;1;0;3;
03;Oslo;0301;Oslo;0810;Skeidhuset;2070;0;1373;1373;0;0;0;1375;1375;0;0;0;6;
03;Oslo;0301;Oslo;0901;Løren skole;5689;0;2616;2616;0;0;0;2620;2620;0;1;0;5;
03;Oslo;0301;Oslo;0902;Årvoll skole;4414;0;2343;2343;0;0;0;2344;2344;0;1;0;6;
03;Oslo;0301;Oslo;0903;Tonsenhagen skole;2598;0;1605;1605;0;0;0;1605;1605;0;1;0;3;
03;Oslo;0301;Oslo;0904;Linderud skole;2366;0;1121;1121;0;0;0;1124;1124;0;0;0;6;
03;Oslo;0301;Oslo;0905;Veitvet skole;3634;0;1352;1352;0;0;0;1353;1353;0;0;0;9;
03;Oslo;0301;Oslo;1001;Rødtvet skole;2428;0;1384;1384;0;0;0;1386;1386;0;1;0;12;
03;Oslo;0301;Oslo;1002;Nordtvet skole;4836;0;2628;2628;0;0;0;2632;2632;0;0;0;12;
03;Oslo;0301;Oslo;1003;Ammerud skole;5990;0;2525;2525;0;0;0;2527;2527;0;0;0;16;
03;Oslo;0301;Oslo;1004;Tiurleiken skole;4600;0;2046;2046;0;0;0;2049;2049;0;0;0;17;
03;Oslo;0301;Oslo;1101;Tokerud skole;4017;0;1841;1841;0;0;0;1842;1842;0;0;0;9;
03;Oslo;0301;Oslo;1102;Stovner videregående skole;3359;0;2033;2033;0;0;0;2032;2032;0;0;0;6;
03;Oslo;0301;Oslo;1103;Stovner skole;5756;0;2536;2536;0;0;0;2538;2538;0;0;0;4;
03;Oslo;0301;Oslo;1104;Stig skole;2467;0;1265;1265;0;0;0;1268;1268;0;0;0;4;
03;Oslo;0301;Oslo;1105;Folkvang ¿ Høybråten;4660;0;2858;2858;0;0;0;2860;2860;0;5;0;7;
03;Oslo;0301;Oslo;1201;Ellingsrudåsen skole;4240;0;2123;2123;0;0;0;2125;2125;0;0;0;8;
03;Oslo;0301;Oslo;1202;Gran skole;5024;0;2038;2038;0;0;0;2042;2042;0;0;0;6;
03;Oslo;0301;Oslo;1203;Furuset skole;1748;0;842;842;0;0;0;844;844;0;0;0;5;
03;Oslo;0301;Oslo;1204;Lindeberg skole;5081;0;2439;2439;0;0;0;2444;2444;0;0;0;11;
03;Oslo;0301;Oslo;1205;Haukåsen skole;5702;0;2319;2319;0;0;0;2324;2324;0;0;0;5;
03;Oslo;0301;Oslo;1206;Hellerud videregående skole;6135;0;2492;2492;0;0;0;2494;2494;0;0;0;13;
03;Oslo;0301;Oslo;1207;Bryn skole;3863;0;1797;1797;0;0;0;1797;1797;0;0;0;16;
03;Oslo;0301;Oslo;1301;Godlia skole;2936;0;1273;1273;0;0;0;1269;1269;0;3;0;3;
03;Oslo;0301;Oslo;1302;Trasop skole;1888;0;1309;1309;0;0;0;1311;1311;0;0;0;10;
03;Oslo;0301;Oslo;1303;Oppsal skole;4215;0;2399;2399;0;0;0;2400;2400;0;0;0;13;
03;Oslo;0301;Oslo;1304;Skøyenåsen skole;1716;0;924;924;0;0;0;924;924;0;0;0;5;
03;Oslo;0301;Oslo;1305;Østensjø skole;2302;0;1146;1146;0;0;0;1146;1146;0;0;0;7;
03;Oslo;0301;Oslo;1306;Manglerud videregående skole;4286;0;2341;2341;0;0;0;2343;2343;0;0;0;8;
03;Oslo;0301;Oslo;1307;Høyenhall skole;3125;0;1813;1813;0;0;0;1977;1977;0;0;0;11;
03;Oslo;0301;Oslo;1308;Abildsø skole;2383;0;1570;1570;0;0;0;1569;1569;0;0;0;8;
03;Oslo;0301;Oslo;1309;Ulsrud videregående skole;5679;0;2395;2395;0;0;0;2395;2395;0;0;0;11;
03;Oslo;0301;Oslo;1310;Skullerud skole;4976;0;2427;2427;0;0;0;2427;2427;0;1;0;11;
03;Oslo;0301;Oslo;1401;Ekeberg skole;3888;0;2407;2407;0;0;0;2405;2405;0;2;0;8;
03;Oslo;0301;Oslo;1402;Bekkelaget skole;6168;0;3632;3632;0;0;0;3640;3640;0;0;0;10;
03;Oslo;0301;Oslo;1403;Nedre Bekkelaget skole;1678;0;1083;1083;0;0;0;1083;1083;0;1;0;2;
03;Oslo;0301;Oslo;1404;Lambertseter videregående skole;2917;0;1825;1825;0;0;0;1826;1826;0;0;0;11;
03;Oslo;0301;Oslo;1405;Lambertseter skole;5349;0;2627;2627;0;0;0;2630;2630;0;1;0;9;
03;Oslo;0301;Oslo;1406;Nordseter skole;4503;0;2675;2675;0;0;0;2676;2676;0;3;0;5;
03;Oslo;0301;Oslo;1407;Nordstrand skole;2941;0;1854;1854;0;0;0;1855;1855;0;0;0;2;
03;Oslo;0301;Oslo;1408;Munkerud skole;3710;0;2434;2434;0;0;0;2437;2437;0;0;0;6;
03;Oslo;0301;Oslo;1409;Ljan skole;2512;0;1632;1632;0;0;0;1632;1632;0;1;0;6;
03;Oslo;0301;Oslo;1501;Hallagerbakken skole;3253;0;1527;1527;0;0;0;1529;1529;0;1;0;7;
03;Oslo;0301;Oslo;1502;Rosenholm skole;2969;0;1384;1384;0;0;0;1383;1383;0;1;0;8;
03;Oslo;0301;Oslo;1503;Toppåsen skole;2899;0;1169;1169;0;0;0;1169;1169;0;0;0;7;
03;Oslo;0301;Oslo;1504;Prinsdal skole;2976;0;1338;1338;0;0;0;1596;1596;0;0;0;5;
03;Oslo;0301;Oslo;1505;Mortensrud skole;4821;0;1689;1689;0;0;0;1690;1690;0;0;0;5;
03;Oslo;0301;Oslo;1506;Klemetsrud skole;1777;0;805;805;0;0;0;805;805;0;0;0;4;
03;Oslo;0301;Oslo;1507;Bjørndal skole;4258;0;2049;2049;0;0;0;2049;2049;0;0;0;11;
03;Oslo;0301;Oslo;1601;Oslo rådhus;1484;0;4013;4013;0;0;0;3787;3787;0;0;0;36;
03;Oslo;0301;Oslo;1701;Sørkedalen skole;494;0;314;314;0;0;0;314;314;0;0;0;2;
03;Oslo;0301;Oslo;1702;Maridalen skole;434;0;310;310;0;0;0;310;310;0;0;0;0;
04;Hedmark;0402;Kongsvinger;0000;Hele kommunen;13625;2746;7340;10086;5;5;2746;7343;10089;2;4;17;52;
04;Hedmark;0403;Hamar;0000;Hele kommunen;22444;5674;12373;18047;3;27;5668;12372;18040;14;25;24;83;
04;Hedmark;0412;Ringsaker;0000;Hele kommunen;25014;5005;13624;18629;1;25;5003;13626;18629;3;7;28;119;
04;Hedmark;0415;Løten;0000;Hele kommunen;5765;1007;3465;4472;0;7;1006;3466;4472;4;5;7;36;
04;Hedmark;0417;Stange;0000;Hele kommunen;14716;2616;9156;11772;0;3;2614;9166;11780;2;10;10;69;
04;Hedmark;0418;Nord-Odal;0000;Hele kommunen;4065;617;2529;3146;0;6;617;2529;3146;1;1;2;13;
04;Hedmark;0419;Sør-Odal;0000;Hele kommunen;6074;1243;3361;4604;0;0;1242;3353;4595;1;1;3;30;
04;Hedmark;0420;Eidskog;0000;Hele kommunen;4913;1100;2469;3569;0;0;1100;2468;3568;0;1;8;28;
04;Hedmark;0423;Grue;0000;Hele kommunen;3939;548;2302;2850;0;11;548;2303;2851;2;3;0;8;
04;Hedmark;0425;Åsnes;0000;Hele kommunen;6050;1223;3139;4362;3;18;1221;3131;4352;5;15;5;24;
04;Hedmark;0426;Våler;0000;Hele kommunen;3036;713;1501;2214;0;7;713;1501;2214;1;2;4;19;
04;Hedmark;0427;Elverum;0000;Hele kommunen;15509;2749;9078;11827;0;32;2781;9043;11824;4;17;16;75;
04;Hedmark;0428;Trysil;0000;Hele kommunen;5113;957;2889;3846;2;7;957;2890;3847;0;1;6;38;
04;Hedmark;0429;Åmot;0000;Hele kommunen;3361;720;1760;2480;0;0;719;1759;2478;0;1;3;21;
04;Hedmark;0430;Stor-Elvdal;0000;Hele kommunen;2019;473;1081;1554;0;2;473;1081;1554;0;0;2;6;
04;Hedmark;0432;Rendalen;0000;Hele kommunen;1533;346;904;1250;0;7;346;924;1270;0;0;0;5;
04;Hedmark;0434;Engerdal;0000;Hele kommunen;1048;167;660;827;0;3;167;661;828;0;0;0;7;
04;Hedmark;0436;Tolga;0000;Hele kommunen;1226;195;798;993;0;3;188;798;986;7;7;0;0;
04;Hedmark;0437;Tynset;0000;Hele kommunen;4031;1723;1492;3215;0;7;1723;1494;3217;2;2;3;6;
04;Hedmark;0438;Alvdal;0000;Hele kommunen;1805;283;1094;1377;0;4;283;1094;1377;0;0;4;9;
04;Hedmark;0439;Folldal;0000;Hele kommunen;1272;233;816;1049;0;0;233;816;1049;0;0;4;12;
04;Hedmark;0441;Os;0000;Hele kommunen;1540;262;962;1224;0;3;260;962;1222;0;0;1;5;
05;Oppland;0501;Lillehammer;0000;Hele kommunen;20337;4823;11219;16042;0;33;4825;11226;16051;7;11;16;73;
05;Oppland;0502;Gjøvik;0000;Hele kommunen;22094;3912;13013;16925;9;19;3912;13019;16931;9;29;19;70;
05;Oppland;0511;Dovre;0000;Hele kommunen;2097;408;1114;1522;0;0;411;1131;1542;0;1;2;4;
05;Oppland;0512;Lesja;0000;Hele kommunen;1579;402;923;1325;0;2;401;838;1239;1;1;3;6;
05;Oppland;0513;Skjåk;0000;Hele kommunen;1747;398;890;1288;0;4;396;890;1286;2;2;4;11;
05;Oppland;0514;Lom;0000;Hele kommunen;1850;420;880;1300;1;5;423;921;1344;0;0;4;6;
05;Oppland;0515;Vågå;0000;Hele kommunen;2861;432;1727;2159;0;4;433;1728;2161;0;0;3;16;
05;Oppland;0516;Nord-Fron;0000;Hele kommunen;4454;766;2518;3284;1;2;764;2517;3281;2;2;5;12;
05;Oppland;0517;Sel;0000;Hele kommunen;4628;998;2308;3306;1;9;997;2307;3304;2;4;4;13;
05;Oppland;0519;Sør-Fron;0000;Hele kommunen;2434;415;1368;1783;0;4;415;1367;1782;0;0;1;11;
05;Oppland;0520;Ringebu;0000;Hele kommunen;3400;514;1986;2500;0;4;514;1986;2500;0;0;3;11;
05;Oppland;0521;Øyer;0000;Hele kommunen;3736;651;2165;2816;0;0;650;2164;2814;1;4;3;15;
05;Oppland;0522;Gausdal;0000;Hele kommunen;4773;912;2595;3507;0;4;911;2595;3506;0;3;6;19;
05;Oppland;0528;Østre Toten;0000;Hele kommunen;11237;1816;6620;8436;0;20;1813;6605;8418;2;4;6;34;
05;Oppland;0529;Vestre Toten;0000;Hele kommunen;10035;1294;6254;7548;1;1;1292;6251;7543;2;5;5;35;
05;Oppland;0532;Jevnaker;0000;Hele kommunen;4855;940;2883;3823;2;14;940;2884;3824;5;9;4;14;
05;Oppland;0533;Lunner;0000;Hele kommunen;6555;1058;4304;5362;0;17;1060;4307;5367;0;1;6;30;
05;Oppland;0534;Gran;0000;Hele kommunen;10241;1964;6052;8016;1;13;1962;6052;8014;15;24;11;39;
05;Oppland;0536;Søndre Land;0000;Hele kommunen;4423;826;2340;3166;0;2;829;2340;3169;3;4;3;13;
05;Oppland;0538;Nordre Land;0000;Hele kommunen;5227;855;2903;3758;0;5;854;2905;3759;0;0;3;19;
05;Oppland;0540;Sør-Aurdal;0000;Hele kommunen;2399;308;1499;1807;0;13;308;1500;1808;0;0;2;6;
05;Oppland;0541;Etnedal;0000;Hele kommunen;1001;296;454;750;0;0;296;455;751;0;0;4;6;
05;Oppland;0542;Nord-Aurdal;0000;Hele kommunen;4834;805;2808;3613;0;11;802;2810;3612;1;2;4;9;
05;Oppland;0543;Vestre Slidre;0000;Hele kommunen;1665;217;1077;1294;0;1;217;1082;1299;0;0;0;9;
05;Oppland;0544;Øystre Slidre;0000;Hele kommunen;2388;392;1298;1690;0;1;391;1298;1689;1;1;0;3;
05;Oppland;0545;Vang;0000;Hele kommunen;1164;199;704;903;0;0;199;704;903;0;1;2;4;
06;Buskerud;0602;Drammen;0000;Hele kommunen;46504;13878;21498;35376;21;81;13945;21513;35458;7;57;45;153;
06;Buskerud;0604;Kongsberg;0000;Hele kommunen;18566;4197;10625;14822;1;17;4198;10641;14839;9;21;18;81;
06;Buskerud;0605;Ringerike;0000;Hele kommunen;22312;4358;12672;17030;2;60;4356;12677;17033;4;16;31;123;
06;Buskerud;0612;Hole;0000;Hele kommunen;4460;976;2721;3697;0;0;985;2722;3707;5;5;8;23;
06;Buskerud;0615;Flå;0000;Hele kommunen;796;161;441;602;0;3;161;441;602;0;0;1;3;
06;Buskerud;0616;Nes;0000;Hele kommunen;2560;413;1471;1884;1;1;416;1471;1887;3;3;1;4;
06;Buskerud;0617;Gol;0000;Hele kommunen;3281;902;1583;2485;0;2;903;1583;2486;0;0;1;6;
06;Buskerud;0618;Hemsedal;0000;Hele kommunen;1417;386;772;1158;0;7;386;772;1158;0;0;2;5;
06;Buskerud;0619;Ål;0000;Hele kommunen;3437;737;1995;2732;1;4;741;1996;2737;0;1;4;15;
06;Buskerud;0620;Hol;0000;Hele kommunen;3192;773;1774;2547;2;5;774;1774;2548;0;0;2;10;
06;Buskerud;0621;Sigdal;0000;Hele kommunen;2679;264;1764;2028;0;2;264;1764;2028;1;1;0;12;
06;Buskerud;0622;Krødsherad;0000;Hele kommunen;1653;257;1007;1264;0;1;258;1009;1267;1;1;2;7;
06;Buskerud;0623;Modum;0000;Hele kommunen;10158;1852;5800;7652;0;16;1852;5801;7653;0;2;14;45;
06;Buskerud;0624;Øvre Eiker;0000;Hele kommunen;12799;1794;8011;9805;0;21;1803;8011;9814;6;10;13;61;
06;Buskerud;0625;Nedre Eiker;0000;Hele kommunen;16669;3174;9630;12804;0;7;3172;9633;12805;3;26;20;83;
06;Buskerud;0626;Lier;0000;Hele kommunen;17263;3240;10815;14055;7;18;3241;10820;14061;9;29;14;76;
06;Buskerud;0627;Røyken;0000;Hele kommunen;13997;2153;9334;11487;10;32;2122;9338;11460;50;81;8;56;
06;Buskerud;0628;Hurum;0000;Hele kommunen;6736;1285;4039;5324;0;18;1260;4036;5296;26;30;1;41;
06;Buskerud;0631;Flesberg;0000;Hele kommunen;1958;385;1139;1524;0;1;386;1139;1525;0;0;1;3;
06;Buskerud;0632;Rollag;0000;Hele kommunen;1047;135;703;838;0;0;135;703;838;0;2;0;2;
06;Buskerud;0633;Nore og Uvdal;0000;Hele kommunen;1920;310;1120;1430;0;0;306;1120;1426;4;4;0;8;
07;Vestfold;0701;Horten;0000;Hele kommunen;19625;5177;10122;15299;2;4;5178;10118;15296;22;31;22;94;
07;Vestfold;0702;Holmestrand;0000;Hele kommunen;7863;1464;4673;6137;4;8;1464;4676;6140;2;7;5;28;
07;Vestfold;0704;Tønsberg;0000;Hele kommunen;30564;6012;18137;24149;9;13;6003;18197;24200;4;5;36;152;
07;Vestfold;0706;Sandefjord;0000;Hele kommunen;32712;7624;17534;25158;1;13;7632;17544;25176;2;3;21;87;
07;Vestfold;0709;Larvik;0000;Hele kommunen;32405;10303;14965;25268;3;33;10305;14986;25291;2;5;55;135;
07;Vestfold;0711;Svelvik;0000;Hele kommunen;4855;863;2805;3668;0;0;839;2839;3678;2;2;4;18;
07;Vestfold;0713;Sande;0000;Hele kommunen;6360;1090;4004;5094;0;8;1088;4004;5092;2;2;5;36;
07;Vestfold;0714;Hof;0000;Hele kommunen;2260;372;1390;1762;9;9;371;1390;1761;0;0;5;10;
07;Vestfold;0716;Re;0000;Hele kommunen;6495;2103;3082;5185;0;4;2105;3083;5188;0;3;19;44;
07;Vestfold;0719;Andebu;0000;Hele kommunen;4102;521;2598;3119;2;7;523;2594;3117;0;1;2;12;
07;Vestfold;0720;Stokke;0000;Hele kommunen;8209;1742;4760;6502;14;16;1742;4757;6499;0;3;1;37;
07;Vestfold;0722;Nøtterøy;0000;Hele kommunen;15750;3583;9309;12892;0;7;3576;9278;12854;8;11;18;31;
07;Vestfold;0723;Tjøme;0000;Hele kommunen;3730;1237;1759;2996;0;0;1244;1760;3004;1;2;2;14;
07;Vestfold;0728;Lardal;0000;Hele kommunen;1849;311;1142;1453;0;0;312;1142;1454;0;0;0;9;
08;Telemark;0805;Porsgrunn;0000;Hele kommunen;26605;4283;16278;20561;15;49;4284;16264;20548;4;9;20;105;
08;Telemark;0806;Skien;0000;Hele kommunen;39656;6572;23526;30098;14;50;6576;23523;30099;9;55;30;140;
08;Telemark;0807;Notodden;0000;Hele kommunen;9460;1557;5552;7109;0;0;1557;5554;7111;0;2;5;23;
08;Telemark;0811;Siljan;0000;Hele kommunen;1796;286;1169;1455;0;0;286;1169;1455;0;0;2;8;
08;Telemark;0814;Bamble;0000;Hele kommunen;10751;1780;6584;8364;4;17;1777;6580;8357;5;11;4;40;
08;Telemark;0815;Kragerø;0000;Hele kommunen;8171;1820;4517;6337;2;9;1822;4516;6338;0;1;8;27;
08;Telemark;0817;Drangedal;0000;Hele kommunen;3082;472;1912;2384;0;1;472;1912;2384;1;1;0;16;
08;Telemark;0819;Nome;0000;Hele kommunen;4974;693;3199;3892;0;0;690;3196;3886;3;4;3;24;
08;Telemark;0821;Bø;0000;Hele kommunen;4180;904;2235;3139;1;10;902;2234;3136;4;4;2;14;
08;Telemark;0822;Sauherad;0000;Hele kommunen;3252;401;2042;2443;0;9;403;2043;2446;4;6;2;11;
08;Telemark;0826;Tinn;0000;Hele kommunen;4473;1031;2376;3407;0;0;1029;2376;3405;3;3;4;17;
08;Telemark;0827;Hjartdal;0000;Hele kommunen;1252;173;764;937;2;2;172;764;936;1;1;0;1;
08;Telemark;0828;Seljord;0000;Hele kommunen;2227;361;1365;1726;0;0;353;1365;1718;8;8;3;4;
08;Telemark;0829;Kviteseid;0000;Hele kommunen;1911;337;1064;1401;0;0;337;1064;1401;0;0;0;2;
08;Telemark;0830;Nissedal;0000;Hele kommunen;1078;203;655;858;1;1;203;656;859;1;1;0;2;
08;Telemark;0831;Fyresdal;0000;Hele kommunen;948;192;528;720;0;1;192;528;720;0;0;1;5;
08;Telemark;0833;Tokke;0000;Hele kommunen;1730;333;1056;1389;0;0;333;1056;1389;0;0;4;9;
08;Telemark;0834;Vinje;0000;Hele kommunen;2806;513;1628;2141;1;6;514;1631;2145;4;6;0;7;
09;Aust-Agder;0901;Risør;0000;Hele kommunen;5202;983;3028;4011;0;4;980;3028;4008;10;17;8;29;
09;Aust-Agder;0904;Grimstad;0000;Hele kommunen;15176;4137;7505;11642;4;63;4132;7510;11642;4;6;18;53;
09;Aust-Agder;0906;Arendal;0000;Hele kommunen;31832;7566;16937;24503;6;49;7575;16942;24517;14;68;20;130;
09;Aust-Agder;0911;Gjerstad;0000;Hele kommunen;1856;368;1056;1424;2;5;369;1055;1424;0;3;0;6;
09;Aust-Agder;0912;Vegårshei;0000;Hele kommunen;1461;307;896;1203;0;1;307;896;1203;0;0;0;5;
09;Aust-Agder;0914;Tvedestrand;0000;Hele kommunen;4514;982;2508;3490;0;11;982;2508;3490;3;3;4;22;
09;Aust-Agder;0919;Froland;0000;Hele kommunen;3869;807;2095;2902;0;7;808;2096;2904;2;2;3;14;
09;Aust-Agder;0926;Lillesand;0000;Hele kommunen;7245;1555;4258;5813;10;11;1555;4265;5820;1;3;4;8;
09;Aust-Agder;0928;Birkenes;0000;Hele kommunen;3444;788;1807;2595;0;3;788;1803;2591;5;5;8;18;
09;Aust-Agder;0929;Åmli;0000;Hele kommunen;1306;199;917;1116;0;3;198;827;1025;0;1;2;6;
09;Aust-Agder;0935;Iveland;0000;Hele kommunen;928;132;630;762;1;1;132;630;762;0;0;2;5;
09;Aust-Agder;0937;Evje og Hornnes;0000;Hele kommunen;2526;405;1489;1894;0;0;405;1489;1894;0;0;5;11;
09;Aust-Agder;0938;Bygland;0000;Hele kommunen;922;157;584;741;0;1;157;584;741;0;0;0;1;
09;Aust-Agder;0940;Valle;0000;Hele kommunen;946;175;521;696;0;3;191;506;697;0;0;0;3;
09;Aust-Agder;0941;Bykle;0000;Hele kommunen;637;157;342;499;0;2;155;342;497;2;2;1;4;
10;Vest-Agder;1001;Kristiansand;0000;Hele kommunen;60894;12710;34651;47361;12;41;12721;34504;47225;37;76;58;175;
10;Vest-Agder;1002;Mandal;0000;Hele kommunen;10978;3527;4960;8487;1;2;3528;4963;8491;3;10;10;28;
10;Vest-Agder;1003;Farsund;0000;Hele kommunen;6891;1728;3498;5226;0;0;1725;3502;5227;6;10;8;25;
10;Vest-Agder;1004;Flekkefjord;0000;Hele kommunen;6560;1530;3566;5096;0;2;1530;3567;5097;2;7;5;18;
10;Vest-Agder;1014;Vennesla;0000;Hele kommunen;9941;1267;6491;7758;0;8;1267;6495;7762;0;1;5;29;
10;Vest-Agder;1017;Songdalen;0000;Hele kommunen;4342;632;2688;3320;0;0;630;2697;3327;2;5;2;12;
10;Vest-Agder;1018;Søgne;0000;Hele kommunen;7758;2301;3766;6067;0;0;2305;3765;6070;6;7;4;7;
10;Vest-Agder;1021;Marnardal;0000;Hele kommunen;1611;270;998;1268;0;4;270;995;1265;0;3;1;8;
10;Vest-Agder;1026;Åseral;0000;Hele kommunen;623;83;405;488;0;2;83;405;488;0;0;1;1;
10;Vest-Agder;1027;Audnedal;0000;Hele kommunen;1205;126;879;1005;0;0;126;879;1005;0;3;1;1;
10;Vest-Agder;1029;Lindesnes;0000;Hele kommunen;3372;610;1959;2569;0;0;594;1985;2579;14;18;0;7;
10;Vest-Agder;1032;Lyngdal;0000;Hele kommunen;5462;1103;3152;4255;2;10;1105;3151;4256;0;3;1;8;
10;Vest-Agder;1034;Hægebostad;0000;Hele kommunen;1205;127;854;981;0;3;128;854;982;1;1;0;2;
10;Vest-Agder;1037;Kvinesdal;0000;Hele kommunen;4196;1026;2178;3204;0;5;1018;2178;3196;7;18;6;22;
10;Vest-Agder;1046;Sirdal;0000;Hele kommunen;1279;306;705;1011;0;2;309;705;1014;0;1;0;1;
11;Rogaland;1101;Eigersund;0000;Hele kommunen;10357;2143;5512;7655;0;5;2146;5509;7655;8;19;9;28;
11;Rogaland;1102;Sandnes;0000;Hele kommunen;46925;16255;20372;36627;1;41;16252;20377;36629;14;41;79;180;
11;Rogaland;1103;Stavanger;0000;Uoppgitt krets;1789;12196;899;13095;0;0;12180;887;13067;42;42;54;63;
11;Rogaland;1103;Stavanger;0001;Buøy/Hundvåg;7853;0;5168;5168;0;0;0;5155;5155;0;0;0;0;
11;Rogaland;1103;Stavanger;0004;Varden;4580;0;2765;2765;0;0;0;2767;2767;0;2;0;16;
11;Rogaland;1103;Stavanger;0005;Storhaug;4831;0;2583;2583;0;0;0;2584;2584;0;1;0;15;
11;Rogaland;1103;Stavanger;0006;Våland;3212;0;2060;2060;0;0;0;2056;2056;0;0;0;0;
11;Rogaland;1103;Stavanger;0007;Ullandhaug;4338;0;2841;2841;0;0;0;2832;2832;0;1;0;0;
11;Rogaland;1103;Stavanger;0008;Eiganes;4623;0;2440;2440;0;0;0;2438;2438;0;0;0;9;
11;Rogaland;1103;Stavanger;0009;Kampen;3609;0;2201;2201;0;0;0;2196;2196;0;0;0;0;
11;Rogaland;1103;Stavanger;0011;Austre Åmøy;187;0;131;131;0;0;0;129;129;0;0;0;0;
11;Rogaland;1103;Stavanger;0013;Roaldsøy;852;0;534;534;0;0;0;534;534;0;0;0;0;
11;Rogaland;1103;Stavanger;0014;Vassøy;524;0;365;365;0;0;0;365;365;0;0;0;2;
11;Rogaland;1103;Stavanger;0016;Gausel;6291;0;4218;4218;0;0;0;4220;4220;0;4;0;20;
11;Rogaland;1103;Stavanger;0017;Hinna;4424;0;2885;2885;0;0;0;2875;2875;0;5;0;12;
11;Rogaland;1103;Stavanger;0018;Vaulen;4111;0;2812;2812;0;0;0;2804;2804;0;0;0;8;
11;Rogaland;1103;Stavanger;0019;Kvaleberg;4397;0;2689;2689;0;0;0;2685;2685;0;0;0;0;
11;Rogaland;1103;Stavanger;0020;Tjensvoll;4247;0;2869;2869;0;0;0;2868;2868;0;1;0;0;
11;Rogaland;1103;Stavanger;0021;Stokka;3630;0;2442;2442;0;0;0;2442;2442;0;0;0;0;
11;Rogaland;1103;Stavanger;0022;Madlamark;4886;0;3329;3329;0;0;0;3323;3323;0;0;0;0;
11;Rogaland;1103;Stavanger;0023;Hafrsfjord;2780;0;1906;1906;0;0;0;1899;1899;0;0;0;0;
11;Rogaland;1103;Stavanger;0024;Kvernavik;3229;0;2086;2086;0;0;0;2081;2081;0;0;0;0;
11;Rogaland;1103;Stavanger;0025;Sunde;3101;0;2085;2085;0;0;0;2078;2078;0;0;0;0;
11;Rogaland;1103;Stavanger;0026;Indre Tasta;3899;0;2524;2524;0;0;0;2515;2515;0;0;0;0;
11;Rogaland;1103;Stavanger;0027;Ytre Tasta;5787;0;3884;3884;0;0;0;3891;3891;0;0;0;20;
11;Rogaland;1106;Haugesund;0000;Hele kommunen;25003;5835;13326;19161;2;21;5832;13331;19163;2;8;16;83;
11;Rogaland;1111;Sokndal;0000;Hele kommunen;2445;404;1509;1913;0;0;404;1509;1913;0;0;0;5;
11;Rogaland;1112;Lund;0000;Hele kommunen;2282;460;1334;1794;0;3;460;1334;1794;0;0;1;2;
11;Rogaland;1114;Bjerkreim;0000;Hele kommunen;1903;282;1290;1572;0;3;283;1291;1574;0;0;0;1;
11;Rogaland;1119;Hå;0000;Hele kommunen;11592;1822;7388;9210;0;2;1826;7388;9214;1;12;5;36;
11;Rogaland;1120;Klepp;0000;Hele kommunen;12141;2374;7172;9546;0;4;2374;7170;9544;2;7;10;41;
11;Rogaland;1121;Time;0000;Hele kommunen;12233;2137;7829;9966;0;5;2136;7836;9972;1;1;12;39;
11;Rogaland;1122;Gjesdal;0000;Hele kommunen;7384;1402;4430;5832;1;10;1400;4438;5838;2;2;3;18;
11;Rogaland;1124;Sola;0000;Hele kommunen;16339;3101;9990;13091;2;23;3101;9995;13096;4;10;10;44;
11;Rogaland;1127;Randaberg;0000;Hele kommunen;7065;1510;4227;5737;4;4;1509;4236;5745;3;4;7;26;
11;Rogaland;1129;Forsand;0000;Hele kommunen;844;165;510;675;0;1;165;510;675;0;0;0;1;
11;Rogaland;1130;Strand;0000;Hele kommunen;8306;1310;5072;6382;0;0;1309;5104;6413;0;0;4;20;
11;Rogaland;1133;Hjelmeland;0000;Hele kommunen;1828;327;1100;1427;0;0;330;1117;1447;0;0;0;5;
11;Rogaland;1134;Suldal;0000;Hele kommunen;2773;524;1650;2174;0;0;514;1649;2163;0;1;3;7;
11;Rogaland;1135;Sauda;0000;Hele kommunen;3565;861;1906;2767;2;3;861;1905;2766;0;4;5;16;
11;Rogaland;1141;Finnøy;0000;Hele kommunen;2054;354;1323;1677;1;2;354;1349;1703;0;0;1;5;
11;Rogaland;1142;Rennesøy;0000;Hele kommunen;3060;437;2083;2520;0;0;438;2087;2525;0;0;2;13;
11;Rogaland;1144;Kvitsøy;0000;Hele kommunen;392;56;286;342;0;2;56;286;342;0;0;0;0;
11;Rogaland;1145;Bokn;0000;Hele kommunen;614;128;359;487;0;0;128;359;487;0;0;0;3;
11;Rogaland;1146;Tysvær;0000;Hele kommunen;7273;1793;4089;5882;4;12;1797;4091;5888;8;11;7;24;
11;Rogaland;1149;Karmøy;0000;Hele kommunen;29354;6860;15493;22353;1;70;6861;15507;22368;0;19;19;73;
11;Rogaland;1151;Utsira;0000;Hele kommunen;157;64;79;143;0;0;64;79;143;0;0;1;2;
11;Rogaland;1160;Vindafjord;0000;Hele kommunen;5919;943;3636;4579;0;5;943;3637;4580;0;0;4;9;
12;Hordaland;1201;Bergen;0000;Uoppgitt krets;2983;58433;63;58496;19;308;58534;13;58547;105;105;239;239;
12;Hordaland;1201;Bergen;0001;Bergen rådhus;6182;0;5179;5179;0;0;0;5179;5179;0;6;0;46;
12;Hordaland;1201;Bergen;0002;Møhlenpris valgkrets;3798;0;1527;1527;0;0;0;1473;1473;0;1;0;9;
12;Hordaland;1201;Bergen;0003;Nordnes valgkrets;3863;0;1755;1755;0;0;0;1758;1758;0;2;0;10;
12;Hordaland;1201;Bergen;0004;Haukeland valgkrets;3916;0;1881;1881;0;0;0;1882;1882;0;0;0;5;
12;Hordaland;1201;Bergen;0007;Ny Krohnborg valgkrets;7878;0;3004;3004;0;0;0;3003;3003;0;6;0;28;
12;Hordaland;1201;Bergen;0009;Bønes valgkrets;4523;0;2935;2935;0;0;0;2935;2935;0;0;0;6;
12;Hordaland;1201;Bergen;0013;Landås valgkrets;6874;0;2870;2870;0;0;0;2870;2870;0;1;0;12;
12;Hordaland;1201;Bergen;0014;Slettebakken valgkrets;5286;0;3778;3778;0;0;0;3796;3796;0;7;0;18;
12;Hordaland;1201;Bergen;0015;Gimle valgkrets;7110;0;2768;2768;0;0;0;2769;2769;0;4;0;18;
12;Hordaland;1201;Bergen;0018;Hellen valgkrets;4692;0;2530;2530;0;0;0;2530;2530;0;6;0;8;
12;Hordaland;1201;Bergen;0019;Rothaugen valgkrets;7229;0;2945;2945;0;0;0;2950;2950;0;7;0;19;
12;Hordaland;1201;Bergen;0022;Eidsvåg valgkrets;3374;0;1635;1635;0;0;0;1637;1637;0;5;0;4;
12;Hordaland;1201;Bergen;0023;Tertnes valgkrets;4803;0;2665;2665;0;0;0;2666;2666;0;6;0;6;
12;Hordaland;1201;Bergen;0024;Mjølkeråen valgkrets;2709;0;1447;1447;0;0;0;1447;1447;0;1;0;8;
12;Hordaland;1201;Bergen;0025;Salhus valgkrets;566;0;357;357;0;0;0;356;356;0;0;0;2;
12;Hordaland;1201;Bergen;0028;Haukedalen valgkrets;4744;0;2151;2151;0;0;0;2151;2151;0;6;0;6;
12;Hordaland;1201;Bergen;0029;Hordvik valgkrets;1671;0;960;960;0;0;0;960;960;0;1;0;5;
12;Hordaland;1201;Bergen;0030;Haukås valgkrets;1619;0;902;902;0;0;0;903;903;0;0;0;14;
12;Hordaland;1201;Bergen;0031;Nyborg valgkrets;6679;0;3338;3338;0;0;0;3339;3339;0;2;0;12;
12;Hordaland;1201;Bergen;0032;Rolland valgkrets;2671;0;1420;1420;0;0;0;1475;1475;0;2;0;7;
12;Hordaland;1201;Bergen;0035;Ytre Arna valgkrets;1941;0;1081;1081;0;0;0;1081;1081;0;0;0;7;
12;Hordaland;1201;Bergen;0036;Indre Arna valgkrets;2806;0;1603;1603;0;0;0;1605;1605;0;2;0;12;
12;Hordaland;1201;Bergen;0037;Garnes valgkrets;2624;0;1474;1474;0;0;0;1474;1474;0;0;0;6;
12;Hordaland;1201;Bergen;0039;Lone valgkrets;2152;0;1234;1234;0;0;0;1234;1234;0;8;0;6;
12;Hordaland;1201;Bergen;0040;Kringlebotn valgkrets;2783;0;1318;1318;0;0;0;1320;1320;0;0;0;5;
12;Hordaland;1201;Bergen;0044;Kaland valgkrets;2326;0;1247;1247;0;0;0;1248;1248;0;0;0;7;
12;Hordaland;1201;Bergen;0045;Kirkevoll valgkrets;3675;0;2177;2177;0;0;0;2176;2176;0;2;0;8;
12;Hordaland;1201;Bergen;0048;Skjold valgkrets;5764;0;2207;2207;0;0;0;2405;2405;0;2;0;8;
12;Hordaland;1201;Bergen;0049;Nesttun valgkrets;6455;0;3957;3957;0;0;0;3963;3963;0;7;0;19;
12;Hordaland;1201;Bergen;0051;Hop valgkrets;2179;0;1031;1031;0;0;0;1031;1031;0;3;0;2;
12;Hordaland;1201;Bergen;0052;Paradis valgkrets;1681;0;1062;1062;0;0;0;1062;1062;0;0;0;2;
12;Hordaland;1201;Bergen;0054;Sandsli valgkrets;3639;0;2167;2167;0;0;0;2167;2167;0;1;0;9;
12;Hordaland;1201;Bergen;0055;Rå valgkrets;4834;0;2240;2240;0;0;0;2241;2241;0;3;0;5;
12;Hordaland;1201;Bergen;0056;Hjellestad valgkrets;1830;0;1077;1077;0;0;0;1078;1078;0;0;0;2;
12;Hordaland;1201;Bergen;0057;Skeie valgkrets;1519;0;1301;1301;0;0;0;1103;1103;0;0;0;1;
12;Hordaland;1201;Bergen;0058;Liland valgkrets;2213;0;1400;1400;0;0;0;1401;1401;0;0;0;8;
12;Hordaland;1201;Bergen;0059;Søreide valgkrets;4090;0;2105;2105;0;0;0;2108;2108;0;2;0;11;
12;Hordaland;1201;Bergen;0061;Lyshovden valgkrets;3305;0;1497;1497;0;0;0;1497;1497;0;2;0;5;
12;Hordaland;1201;Bergen;0062;Lynghaug valgkrets;5446;0;2391;2391;0;0;0;2392;2392;0;4;0;10;
12;Hordaland;1201;Bergen;0063;Ortun valgkrets;8343;0;4091;4091;0;0;0;4092;4092;0;4;0;16;
12;Hordaland;1201;Bergen;0067;Olsvik valgkrets;5954;0;2797;2797;0;0;0;2800;2800;0;9;0;20;
12;Hordaland;1201;Bergen;0068;Vadmyra valgkrets;4905;0;2615;2615;0;0;0;2616;2616;0;7;0;23;
12;Hordaland;1201;Bergen;0069;Mathopen valgkrets;2091;0;1222;1222;0;0;0;1222;1222;0;1;0;3;
12;Hordaland;1201;Bergen;0070;Alvøen valgkrets;3701;0;1820;1820;0;0;0;1821;1821;0;2;0;9;
12;Hordaland;1201;Bergen;0071;Bjørndalsskogen valgkrets;1818;0;916;916;0;0;0;917;917;0;0;0;7;
12;Hordaland;1201;Bergen;0074;Damsgård valgkrets;5027;0;2173;2173;0;0;0;2174;2174;0;0;0;24;
12;Hordaland;1201;Bergen;0076;Nygårdslien valgkrets;4726;0;2379;2379;0;0;0;2383;2383;0;4;0;7;
12;Hordaland;1201;Bergen;0077;Sædalen valgkrets;2351;0;1304;1304;0;0;0;1304;1304;0;0;0;8;
12;Hordaland;1211;Etne;0000;Hele kommunen;2857;641;1605;2246;0;1;642;1605;2247;1;2;3;10;
12;Hordaland;1216;Sveio;0000;Hele kommunen;3729;908;2046;2954;1;2;909;2046;2955;0;0;3;11;
12;Hordaland;1219;Bømlo;0000;Hele kommunen;8069;1975;4502;6477;0;0;1975;4502;6477;2;2;9;18;
12;Hordaland;1221;Stord;0000;Hele kommunen;12817;3214;6918;10132;2;34;3210;6883;10093;6;22;13;64;
12;Hordaland;1222;Fitjar;0000;Hele kommunen;2133;330;1428;1758;1;4;331;1428;1759;0;2;1;5;
12;Hordaland;1223;Tysnes;0000;Hele kommunen;2062;493;1131;1624;3;6;494;1131;1625;0;1;0;6;
12;Hordaland;1224;Kvinnherad;0000;Hele kommunen;9678;1893;5465;7358;7;7;1881;5465;7346;27;35;9;44;
12;Hordaland;1227;Jondal;0000;Hele kommunen;828;206;463;669;0;0;204;477;681;0;3;0;1;
12;Hordaland;1228;Odda;0000;Hele kommunen;5321;1641;2384;4025;0;6;1645;2388;4033;8;9;14;21;
12;Hordaland;1231;Ullensvang;0000;Hele kommunen;2465;873;1082;1955;0;1;875;1082;1957;1;3;1;6;
12;Hordaland;1232;Eidfjord;0000;Hele kommunen;719;194;366;560;0;0;194;366;560;0;1;0;2;
12;Hordaland;1233;Ulvik;0000;Hele kommunen;809;246;405;651;0;0;245;404;649;1;2;0;4;
12;Hordaland;1234;Granvin;0000;Hele kommunen;705;182;380;562;0;1;184;380;564;0;0;0;0;
12;Hordaland;1235;Voss;0000;Hele kommunen;10525;2523;5702;8225;0;26;2506;5701;8207;17;19;9;36;
12;Hordaland;1238;Kvam;0000;Hele kommunen;6221;1621;3398;5019;2;12;1622;3378;5000;15;18;12;24;
12;Hordaland;1241;Fusa;0000;Hele kommunen;2776;625;1635;2260;0;2;625;1635;2260;0;1;4;9;
12;Hordaland;1242;Samnanger;0000;Hele kommunen;1828;353;1126;1479;0;0;353;1137;1490;0;0;1;3;
12;Hordaland;1243;Os;0000;Hele kommunen;12633;3175;7104;10279;8;32;3174;7108;10282;6;12;9;59;
12;Hordaland;1244;Austevoll;0000;Hele kommunen;3312;784;1905;2689;2;16;827;1908;2735;3;3;2;8;
12;Hordaland;1245;Sund;0000;Hele kommunen;4557;879;2765;3644;1;3;879;2765;3644;0;1;3;14;
12;Hordaland;1246;Fjell;0000;Hele kommunen;16277;4032;8917;12949;0;22;4030;8920;12950;9;11;18;68;
12;Hordaland;1247;Askøy;0000;Hele kommunen;18709;4169;11002;15171;1;24;4169;10999;15168;10;19;14;79;
12;Hordaland;1251;Vaksdal;0000;Hele kommunen;3096;576;1873;2449;0;2;569;1873;2442;13;16;3;20;
12;Hordaland;1252;Modalen;0000;Hele kommunen;276;42;150;192;0;0;42;150;192;0;0;1;2;
12;Hordaland;1253;Osterøy;0000;Hele kommunen;5528;1064;3485;4549;0;3;1064;3486;4550;1;1;4;19;
12;Hordaland;1256;Meland;0000;Hele kommunen;5104;1106;3021;4127;0;7;1109;3022;4131;0;0;8;25;
12;Hordaland;1259;Øygarden;0000;Hele kommunen;3272;953;1720;2673;0;4;952;1719;2671;1;1;6;14;
12;Hordaland;1260;Radøy;0000;Hele kommunen;3553;1456;1443;2899;0;2;1454;1447;2901;0;2;3;8;
12;Hordaland;1263;Lindås;0000;Hele kommunen;10620;2392;6070;8462;0;0;2436;6183;8619;4;6;18;40;
12;Hordaland;1264;Austrheim;0000;Hele kommunen;1962;524;1070;1594;0;5;546;1082;1628;0;1;2;4;
12;Hordaland;1265;Fedje;0000;Hele kommunen;421;165;211;376;0;1;165;211;376;0;0;1;1;
12;Hordaland;1266;Masfjorden;0000;Hele kommunen;1286;222;820;1042;0;0;221;839;1060;1;1;0;3;
14;Sogn og Fjordane;1401;Flora;0000;Hele kommunen;8221;1953;4293;6246;0;0;1967;4295;6262;0;0;8;28;
14;Sogn og Fjordane;1411;Gulen;0000;Hele kommunen;1719;429;959;1388;3;3;430;975;1405;3;5;1;6;
14;Sogn og Fjordane;1412;Solund;0000;Hele kommunen;623;229;262;491;0;0;229;260;489;0;0;0;0;
14;Sogn og Fjordane;1413;Hyllestad;0000;Hele kommunen;1030;329;467;796;0;0;329;467;796;0;0;2;5;
14;Sogn og Fjordane;1416;Høyanger;0000;Hele kommunen;3110;563;1811;2374;0;4;563;1810;2373;0;1;3;11;
14;Sogn og Fjordane;1417;Vik;0000;Hele kommunen;2029;404;1155;1559;0;4;405;1155;1560;1;1;3;10;
14;Sogn og Fjordane;1418;Balestrand;0000;Hele kommunen;951;224;524;748;0;2;224;524;748;0;0;4;5;
14;Sogn og Fjordane;1419;Leikanger;0000;Hele kommunen;1668;349;1037;1386;0;0;349;1037;1386;0;0;0;2;
14;Sogn og Fjordane;1420;Sogndal;0000;Hele kommunen;5389;1195;3127;4322;5;9;1193;3127;4320;3;4;7;18;
14;Sogn og Fjordane;1421;Aurland;0000;Hele kommunen;1291;240;753;993;0;0;241;753;994;0;0;1;6;
14;Sogn og Fjordane;1422;Lærdal;0000;Hele kommunen;1634;340;947;1287;0;0;340;947;1287;0;0;2;5;
14;Sogn og Fjordane;1424;Årdal;0000;Hele kommunen;4126;769;2415;3184;0;0;761;2416;3177;7;16;6;11;
14;Sogn og Fjordane;1426;Luster;0000;Hele kommunen;3728;802;2191;2993;0;3;802;2191;2993;0;0;5;10;
14;Sogn og Fjordane;1428;Askvoll;0000;Hele kommunen;2296;466;1326;1792;0;1;466;1325;1791;3;4;3;7;
14;Sogn og Fjordane;1429;Fjaler;0000;Hele kommunen;1972;396;1175;1571;0;4;397;1174;1571;0;2;0;3;
14;Sogn og Fjordane;1430;Gaular;0000;Hele kommunen;2101;512;1199;1711;0;1;511;1199;1710;4;4;2;4;
14;Sogn og Fjordane;1431;Jølster;0000;Hele kommunen;2149;364;1349;1713;0;2;361;1347;1708;1;2;1;9;
14;Sogn og Fjordane;1432;Førde;0000;Hele kommunen;8830;2039;4974;7013;0;2;2043;4977;7020;0;0;9;33;
14;Sogn og Fjordane;1433;Naustdal;0000;Hele kommunen;2028;373;1235;1608;0;2;370;1235;1605;3;3;0;5;
14;Sogn og Fjordane;1438;Bremanger;0000;Hele kommunen;2767;1054;1075;2129;0;1;1054;1075;2129;0;0;2;8;
14;Sogn og Fjordane;1439;Vågsøy;0000;Hele kommunen;4385;1176;2159;3335;2;4;1185;2160;3345;5;7;3;11;
14;Sogn og Fjordane;1441;Selje;0000;Hele kommunen;2113;433;1185;1618;0;1;432;1186;1618;1;1;1;4;
14;Sogn og Fjordane;1443;Eid;0000;Hele kommunen;4284;908;2449;3357;33;39;905;2449;3354;1;2;7;19;
14;Sogn og Fjordane;1444;Hornindal;0000;Hele kommunen;897;191;561;752;0;1;190;561;751;1;1;4;8;
14;Sogn og Fjordane;1445;Gloppen;0000;Hele kommunen;4203;879;2577;3456;1;9;875;2577;3452;4;4;4;11;
14;Sogn og Fjordane;1449;Stryn;0000;Hele kommunen;4736;720;2861;3581;2;13;719;2862;3581;3;4;4;14;
15;Møre og Romsdal;1502;Molde;0000;Hele kommunen;19019;4156;10678;14834;0;19;4156;10675;14831;1;2;18;44;
15;Møre og Romsdal;1504;Ålesund;0000;Hele kommunen;32320;12945;11832;24777;2;74;12941;11836;24777;14;19;59;107;
15;Møre og Romsdal;1505;Kristiansund;0000;Hele kommunen;17755;4001;9260;13261;2;46;4001;9262;13263;7;22;18;71;
15;Møre og Romsdal;1511;Vanylven;0000;Hele kommunen;2574;512;1472;1984;0;4;511;1471;1982;1;2;2;7;
15;Møre og Romsdal;1514;Sande;0000;Hele kommunen;1819;352;1092;1444;0;0;351;1091;1442;1;1;0;8;
15;Møre og Romsdal;1515;Herøy;0000;Hele kommunen;6309;1423;3440;4863;0;0;1422;3441;4863;2;3;1;8;
15;Møre og Romsdal;1516;Ulstein;0000;Hele kommunen;5280;1018;3225;4243;1;10;1016;3227;4243;4;5;5;15;
15;Møre og Romsdal;1517;Hareid;0000;Hele kommunen;3520;701;2065;2766;0;0;705;2065;2770;0;1;2;9;
15;Møre og Romsdal;1519;Volda;0000;Hele kommunen;6435;1318;3823;5141;5;34;1319;3821;5140;1;3;8;29;
15;Møre og Romsdal;1520;Ørsta;0000;Hele kommunen;7745;1283;4660;5943;0;10;1286;4659;5945;1;2;6;41;
15;Møre og Romsdal;1523;Ørskog;0000;Hele kommunen;1617;256;1023;1279;0;1;258;1023;1281;0;0;1;9;
15;Møre og Romsdal;1524;Norddal;0000;Hele kommunen;1228;225;712;937;0;1;228;712;940;0;0;0;3;
15;Møre og Romsdal;1525;Stranda;0000;Hele kommunen;3214;671;1785;2456;0;4;673;1786;2459;1;1;5;12;
15;Møre og Romsdal;1526;Stordal;0000;Hele kommunen;687;142;355;497;0;0;142;355;497;0;0;0;2;
15;Møre og Romsdal;1528;Sykkylven;0000;Hele kommunen;5441;1049;3094;4143;0;8;1049;3093;4142;8;9;3;13;
15;Møre og Romsdal;1529;Skodje;0000;Hele kommunen;3049;446;1939;2385;0;6;444;1939;2383;4;4;2;12;
15;Møre og Romsdal;1531;Sula;0000;Hele kommunen;5879;795;3760;4555;0;6;793;3761;4554;4;12;3;19;
15;Møre og Romsdal;1532;Giske;0000;Hele kommunen;5213;855;3274;4129;0;6;854;3270;4124;3;6;3;10;
15;Møre og Romsdal;1534;Haram;0000;Hele kommunen;6248;770;4036;4806;0;13;771;4036;4807;0;1;3;20;
15;Møre og Romsdal;1535;Vestnes;0000;Hele kommunen;4819;963;2671;3634;0;0;962;2674;3636;1;2;2;9;
15;Møre og Romsdal;1539;Rauma;0000;Hele kommunen;5552;1508;2582;4090;0;7;1509;2580;4089;6;7;5;22;
15;Møre og Romsdal;1543;Nesset;0000;Hele kommunen;2327;319;1374;1693;0;5;318;1374;1692;4;4;2;4;
15;Møre og Romsdal;1545;Midsund;0000;Hele kommunen;1380;226;816;1042;0;0;226;838;1064;0;0;1;4;
15;Møre og Romsdal;1546;Sandøy;0000;Hele kommunen;905;182;522;704;0;0;182;522;704;0;0;1;4;
15;Møre og Romsdal;1547;Aukra;0000;Hele kommunen;2357;389;1396;1785;0;0;389;1400;1789;0;1;4;9;
15;Møre og Romsdal;1548;Fræna;0000;Hele kommunen;7044;1014;4215;5229;0;11;1012;4217;5229;2;3;2;17;
15;Møre og Romsdal;1551;Eide;0000;Hele kommunen;2473;428;1471;1899;0;0;429;1470;1899;1;2;1;4;
15;Møre og Romsdal;1554;Averøy;0000;Hele kommunen;4107;820;2306;3126;0;4;804;2306;3110;14;14;2;10;
15;Møre og Romsdal;1557;Gjemnes;0000;Hele kommunen;1898;333;1124;1457;1;4;333;1123;1456;0;1;1;10;
15;Møre og Romsdal;1560;Tingvoll;0000;Hele kommunen;2306;453;1319;1772;0;0;453;1319;1772;1;4;4;9;
15;Møre og Romsdal;1563;Sunndal;0000;Hele kommunen;5453;1103;3155;4258;0;9;1102;3153;4255;3;3;2;10;
15;Møre og Romsdal;1566;Surnadal;0000;Hele kommunen;4589;748;2589;3337;1;4;750;2589;3339;5;8;6;11;
15;Møre og Romsdal;1567;Rindal;0000;Hele kommunen;1598;300;927;1227;0;0;300;926;1226;0;0;2;5;
15;Møre og Romsdal;1571;Halsa;0000;Hele kommunen;1252;275;672;947;0;0;275;672;947;1;1;1;4;
15;Møre og Romsdal;1573;Smøla;0000;Hele kommunen;1645;372;875;1247;1;4;373;875;1248;5;6;6;9;
15;Møre og Romsdal;1576;Aure;0000;Hele kommunen;2625;638;1347;1985;0;1;637;1347;1984;3;3;7;11;
16;Sør-Trøndelag;1601;Trondheim;0000;Uoppgitt krets;1683;40616;69;40685;46;181;40654;140;40794;118;140;156;211;
16;Sør-Trøndelag;1601;Trondheim;0001;Sverresborg;4770;0;2369;2369;0;0;0;2371;2371;0;3;0;8;
16;Sør-Trøndelag;1601;Trondheim;0002;Ila;4242;0;2020;2020;0;0;0;2021;2021;0;3;0;14;
16;Sør-Trøndelag;1601;Trondheim;0003;Midtbyen;3331;0;1834;1834;0;0;0;1831;1831;0;0;0;13;
16;Sør-Trøndelag;1601;Trondheim;0004;Elgeseter/Øya;2714;0;1263;1263;0;0;0;1264;1264;0;0;0;5;
16;Sør-Trøndelag;1601;Trondheim;0005;Singsaker;2195;0;1056;1056;0;0;0;1063;1063;0;1;0;0;
16;Sør-Trøndelag;1601;Trondheim;0006;Rosenborg;4415;0;2184;2184;0;0;0;2175;2175;0;0;0;0;
16;Sør-Trøndelag;1601;Trondheim;0007;Lademoen;3728;0;1459;1459;0;0;0;1451;1451;0;0;0;8;
16;Sør-Trøndelag;1601;Trondheim;0008;Tonstad;5817;0;2627;2627;0;0;0;2632;2632;0;3;0;18;
16;Sør-Trøndelag;1601;Trondheim;0009;Lade;3956;0;1789;1789;0;0;0;1791;1791;0;0;0;11;
16;Sør-Trøndelag;1601;Trondheim;0010;Trolla;384;0;235;235;0;0;0;236;236;0;0;0;0;
16;Sør-Trøndelag;1601;Trondheim;0011;Ranheim;3474;0;1986;1986;0;0;0;1995;1995;0;2;0;9;
16;Sør-Trøndelag;1601;Trondheim;0012;Charlottenlund;5223;0;2898;2898;0;0;0;2897;2897;0;6;0;7;
16;Sør-Trøndelag;1601;Trondheim;0013;Strindheim;5672;0;2701;2701;0;0;0;2689;2689;0;0;0;0;
16;Sør-Trøndelag;1601;Trondheim;0014;Blussuvoll;3262;0;1741;1741;0;0;0;1740;1740;0;3;0;9;
16;Sør-Trøndelag;1601;Trondheim;0015;Nidarvoll;6107;0;3191;3191;0;0;0;3191;3191;0;9;0;15;
16;Sør-Trøndelag;1601;Trondheim;0016;Nardo;3403;0;1502;1502;0;0;0;1502;1502;0;0;0;3;
16;Sør-Trøndelag;1601;Trondheim;0017;Åsvang;4137;0;1988;1988;0;0;0;1989;1989;0;1;0;6;
16;Sør-Trøndelag;1601;Trondheim;0018;Solbakken;716;0;301;301;0;0;0;301;301;0;0;0;0;
16;Sør-Trøndelag;1601;Trondheim;0019;Bratsberg;695;0;422;422;0;0;0;422;422;0;0;0;4;
16;Sør-Trøndelag;1601;Trondheim;0020;Hoeggen;2845;0;1458;1458;0;0;0;1458;1458;0;0;0;6;
16;Sør-Trøndelag;1601;Trondheim;0021;Hallset;2980;0;1598;1598;0;0;0;1601;1601;0;7;0;7;
16;Sør-Trøndelag;1601;Trondheim;0022;Byåsen;5509;0;2737;2737;0;0;0;2739;2739;0;5;0;4;
16;Sør-Trøndelag;1601;Trondheim;0023;Romolslia;1988;0;1056;1056;0;0;0;1058;1058;0;0;0;4;
16;Sør-Trøndelag;1601;Trondheim;0024;Breidablikk;2216;0;1106;1106;0;0;0;1106;1106;0;0;0;2;
16;Sør-Trøndelag;1601;Trondheim;0025;Sjetne;3294;0;1872;1872;0;0;0;1875;1875;0;0;0;6;
16;Sør-Trøndelag;1601;Trondheim;0026;Kolstad;4431;0;1973;1973;0;0;0;1970;1970;0;0;0;15;
16;Sør-Trøndelag;1601;Trondheim;0027;Flatåsen;4101;0;2239;2239;0;0;0;2244;2244;0;3;0;16;
16;Sør-Trøndelag;1601;Trondheim;0028;Nypvang;1297;0;746;746;0;0;0;746;746;0;0;0;1;
16;Sør-Trøndelag;1601;Trondheim;0029;Åsheim;3508;0;1883;1883;0;0;0;1883;1883;0;1;0;12;
16;Sør-Trøndelag;1601;Trondheim;0030;Spongdal;973;0;663;663;0;0;0;663;663;0;0;0;5;
16;Sør-Trøndelag;1601;Trondheim;0031;Ugla;5975;0;3261;3261;0;0;0;3256;3256;0;0;0;0;
16;Sør-Trøndelag;1601;Trondheim;0032;Rye;1160;0;759;759;0;0;0;760;760;0;0;0;4;
16;Sør-Trøndelag;1601;Trondheim;0033;Åsveien;2268;0;1274;1274;0;0;0;1268;1268;0;0;0;0;
16;Sør-Trøndelag;1601;Trondheim;0034;Utleira;2866;0;1461;1461;0;0;0;1463;1463;0;0;0;3;
16;Sør-Trøndelag;1601;Trondheim;0035;Stabbursmoen;3937;0;2065;2065;0;0;0;2065;2065;0;0;0;8;
16;Sør-Trøndelag;1601;Trondheim;0036;Brundalen;3114;0;1326;1326;0;0;0;1324;1324;0;0;0;0;
16;Sør-Trøndelag;1601;Trondheim;0037;Eberg;3790;0;1569;1569;0;0;0;1572;1572;0;0;0;7;
16;Sør-Trøndelag;1601;Trondheim;0038;Møllenberg;3152;0;1365;1365;0;0;0;1355;1355;0;0;0;0;
16;Sør-Trøndelag;1601;Trondheim;0039;Vikåsen;2196;0;1332;1332;0;0;0;1334;1334;0;0;0;5;
16;Sør-Trøndelag;1612;Hemne;0000;Hele kommunen;3182;514;1866;2380;0;0;511;1866;2377;2;2;1;3;
16;Sør-Trøndelag;1613;Snillfjord;0000;Hele kommunen;768;134;457;591;0;1;134;457;591;0;0;0;3;
16;Sør-Trøndelag;1617;Hitra;0000;Hele kommunen;3027;644;1548;2192;1;12;642;1559;2201;1;1;4;9;
16;Sør-Trøndelag;1620;Frøya;0000;Hele kommunen;2986;482;1604;2086;0;7;482;1604;2086;0;0;3;10;
16;Sør-Trøndelag;1621;Ørland;0000;Hele kommunen;3944;917;2019;2936;1;14;916;2020;2936;0;0;11;20;
16;Sør-Trøndelag;1622;Agdenes;0000;Hele kommunen;1323;294;723;1017;0;0;294;723;1017;0;0;2;3;
16;Sør-Trøndelag;1624;Rissa;0000;Hele kommunen;4840;805;2854;3659;0;18;810;2854;3664;3;3;6;13;
16;Sør-Trøndelag;1627;Bjugn;0000;Hele kommunen;3565;634;1965;2599;0;0;634;1965;2599;3;6;2;9;
16;Sør-Trøndelag;1630;Åfjord;0000;Hele kommunen;2552;510;1401;1911;1;7;551;1359;1910;1;1;4;9;
16;Sør-Trøndelag;1632;Roan;0000;Hele kommunen;780;163;421;584;0;0;163;420;583;0;1;0;3;
16;Sør-Trøndelag;1633;Osen;0000;Hele kommunen;787;177;417;594;0;0;179;417;596;0;0;1;4;
16;Sør-Trøndelag;1634;Oppdal;0000;Hele kommunen;5052;1217;2688;3905;0;1;1225;2687;3912;1;2;9;22;
16;Sør-Trøndelag;1635;Rennebu;0000;Hele kommunen;1999;367;1128;1495;0;0;368;1166;1534;0;0;2;6;
16;Sør-Trøndelag;1636;Meldal;0000;Hele kommunen;3039;550;1773;2323;0;3;549;1774;2323;1;1;3;19;
16;Sør-Trøndelag;1638;Orkdal;0000;Hele kommunen;8628;1390;5132;6522;0;3;1388;5132;6520;1;7;7;29;
16;Sør-Trøndelag;1640;Røros;0000;Hele kommunen;4339;714;2767;3481;0;0;716;2767;3483;1;1;7;23;
16;Sør-Trøndelag;1644;Holtålen;0000;Hele kommunen;1590;330;979;1309;0;0;333;986;1319;0;0;0;3;
16;Sør-Trøndelag;1648;Midtre Gauldal;0000;Hele kommunen;4403;738;2649;3387;0;8;739;2649;3388;0;0;3;14;
16;Sør-Trøndelag;1653;Melhus;0000;Hele kommunen;11441;2396;6740;9136;2;17;2399;6740;9139;6;8;8;46;
16;Sør-Trøndelag;1657;Skaun;0000;Hele kommunen;5205;848;3322;4170;0;2;848;3322;4170;0;0;5;19;
16;Sør-Trøndelag;1662;Klæbu;0000;Hele kommunen;4152;849;2445;3294;0;5;849;2446;3295;0;0;4;17;
16;Sør-Trøndelag;1663;Malvik;0000;Hele kommunen;9250;2337;5195;7532;0;8;2330;5195;7525;0;6;5;29;
16;Sør-Trøndelag;1664;Selbu;0000;Hele kommunen;3084;482;1860;2342;0;4;527;1815;2342;0;0;6;16;
16;Sør-Trøndelag;1665;Tydal;0000;Hele kommunen;689;156;382;538;1;4;156;382;538;1;1;0;2;
17;Nord-Trøndelag;1702;Steinkjer;0000;Hele kommunen;16229;3726;8715;12441;1;51;3724;8719;12443;7;10;17;50;
17;Nord-Trøndelag;1703;Namsos;0000;Hele kommunen;9558;1783;5340;7123;0;15;1787;5341;7128;0;1;12;30;
17;Nord-Trøndelag;1711;Meråker;0000;Hele kommunen;1915;414;963;1377;2;4;413;957;1370;1;1;2;2;
17;Nord-Trøndelag;1714;Stjørdal;0000;Hele kommunen;16445;3086;9765;12851;2;47;3084;9765;12849;16;23;15;74;
17;Nord-Trøndelag;1717;Frosta;0000;Hele kommunen;1923;281;1234;1515;0;1;282;1234;1516;0;3;2;11;
17;Nord-Trøndelag;1718;Leksvik;0000;Hele kommunen;2654;534;1460;1994;0;0;533;1461;1994;0;0;4;5;
17;Nord-Trøndelag;1719;Levanger;0000;Hele kommunen;14093;3366;7710;11076;0;16;3365;7712;11077;7;12;13;43;
17;Nord-Trøndelag;1721;Verdal;0000;Hele kommunen;10860;2218;5976;8194;2;11;2217;5979;8196;12;12;23;46;
17;Nord-Trøndelag;1724;Verran;0000;Hele kommunen;1903;353;1055;1408;1;6;352;1055;1407;1;7;1;6;
17;Nord-Trøndelag;1725;Namdalseid;0000;Hele kommunen;1311;211;807;1018;0;2;211;807;1018;1;1;0;4;
17;Nord-Trøndelag;1736;Snåsa;0000;Hele kommunen;1682;372;967;1339;1;3;372;967;1339;0;0;0;4;
17;Nord-Trøndelag;1738;Lierne;0000;Hele kommunen;1056;166;576;742;0;0;165;574;739;0;0;0;1;
17;Nord-Trøndelag;1739;Røyrvik;0000;Hele kommunen;379;111;203;314;0;0;113;203;316;1;2;0;2;
17;Nord-Trøndelag;1740;Namsskogan;0000;Hele kommunen;727;203;344;547;0;1;202;344;546;8;8;4;5;
17;Nord-Trøndelag;1742;Grong;0000;Hele kommunen;1799;375;1104;1479;0;5;375;1104;1479;0;0;1;6;
17;Nord-Trøndelag;1743;Høylandet;0000;Hele kommunen;924;193;561;754;0;0;192;575;767;0;0;0;3;
17;Nord-Trøndelag;1744;Overhalla;0000;Hele kommunen;2718;485;1711;2196;0;4;485;1711;2196;0;0;4;10;
17;Nord-Trøndelag;1748;Fosnes;0000;Hele kommunen;501;107;286;393;0;1;107;286;393;0;4;0;1;
17;Nord-Trøndelag;1749;Flatanger;0000;Hele kommunen;858;203;461;664;1;1;204;461;665;0;0;2;3;
17;Nord-Trøndelag;1750;Vikna;0000;Hele kommunen;3072;602;1671;2273;0;5;602;1670;2272;0;2;2;8;
17;Nord-Trøndelag;1751;Nærøy;0000;Hele kommunen;3823;668;2026;2694;0;9;668;2023;2691;0;0;5;15;
17;Nord-Trøndelag;1755;Leka;0000;Hele kommunen;452;122;232;354;0;0;120;232;352;2;2;0;1;
17;Nord-Trøndelag;1756;Inderøy;0000;Hele kommunen;5039;916;3162;4078;0;10;915;3175;4090;3;3;2;13;
18;Nordland;1804;Bodø;0000;Hele kommunen;36310;15891;12700;28591;2;106;15890;12722;28612;21;39;89;145;
18;Nordland;1805;Narvik;0000;Hele kommunen;13728;2524;7671;10195;0;20;2522;7675;10197;7;11;10;42;
18;Nordland;1811;Bindal;0000;Hele kommunen;1225;286;705;991;0;0;285;705;990;4;4;5;7;
18;Nordland;1812;Sømna;0000;Hele kommunen;1556;257;940;1197;0;2;257;940;1197;0;0;2;4;
18;Nordland;1813;Brønnøy;0000;Hele kommunen;5811;1055;3144;4199;0;18;1055;3143;4198;0;0;4;24;
18;Nordland;1815;Vega;0000;Hele kommunen;974;264;508;772;0;3;264;508;772;0;0;0;1;
18;Nordland;1816;Vevelstad;0000;Hele kommunen;380;112;172;284;0;0;112;172;284;0;0;2;2;
18;Nordland;1818;Herøy;0000;Hele kommunen;1265;257;629;886;0;0;257;629;886;0;0;0;0;
18;Nordland;1820;Alstahaug;0000;Hele kommunen;5468;1403;2488;3891;1;9;1404;2489;3893;7;7;15;24;
18;Nordland;1822;Leirfjord;0000;Hele kommunen;1631;323;877;1200;2;5;321;877;1198;2;2;2;4;
18;Nordland;1824;Vefsn;0000;Hele kommunen;10210;3820;3692;7512;3;6;3822;3693;7515;4;16;25;44;
18;Nordland;1825;Grane;0000;Hele kommunen;1134;265;595;860;0;1;265;595;860;0;0;1;2;
18;Nordland;1826;Hattfjelldal;0000;Hele kommunen;1096;204;668;872;0;0;203;667;870;1;2;3;3;
18;Nordland;1827;Dønna;0000;Hele kommunen;1083;217;571;788;0;1;216;571;787;1;1;1;1;
18;Nordland;1828;Nesna;0000;Hele kommunen;1315;372;624;996;0;9;372;619;991;0;8;2;8;
18;Nordland;1832;Hemnes;0000;Hele kommunen;3522;476;2219;2695;0;0;469;2216;2685;13;13;4;10;
18;Nordland;1833;Rana;0000;Hele kommunen;19531;4463;10198;14661;0;29;4463;10197;14660;6;16;25;80;
18;Nordland;1834;Lurøy;0000;Hele kommunen;1443;309;817;1126;0;0;309;828;1137;0;1;1;3;
18;Nordland;1835;Træna;0000;Hele kommunen;312;89;137;226;0;0;91;137;228;0;0;2;5;
18;Nordland;1836;Rødøy;0000;Hele kommunen;942;227;506;733;0;0;227;503;730;0;0;2;4;
18;Nordland;1837;Meløy;0000;Hele kommunen;4892;1129;2349;3478;1;1;1127;2348;3475;1;1;5;16;
18;Nordland;1838;Gildeskål;0000;Hele kommunen;1530;268;888;1156;0;5;267;888;1155;3;4;2;8;
18;Nordland;1839;Beiarn;0000;Hele kommunen;898;165;496;661;1;1;165;497;662;1;5;2;6;
18;Nordland;1840;Saltdal;0000;Hele kommunen;3643;666;2082;2748;0;0;666;2085;2751;5;14;5;26;
18;Nordland;1841;Fauske;0000;Hele kommunen;7350;1587;3903;5490;0;8;1591;3906;5497;6;9;9;31;
18;Nordland;1845;Sørfold;0000;Hele kommunen;1534;376;808;1184;7;8;373;808;1181;4;5;2;3;
18;Nordland;1848;Steigen;0000;Hele kommunen;1979;495;950;1445;0;4;496;954;1450;0;1;2;6;
18;Nordland;1849;Hamarøy;0000;Hele kommunen;1368;272;741;1013;0;3;273;754;1027;5;5;8;8;
18;Nordland;1850;Tysfjord;0000;Hele kommunen;1562;403;798;1201;1;1;402;806;1208;0;2;0;4;
18;Nordland;1851;Lødingen;0000;Hele kommunen;1652;430;889;1319;0;4;425;888;1313;6;6;4;6;
18;Nordland;1852;Tjeldsund;0000;Hele kommunen;1041;153;638;791;0;3;152;638;790;0;1;2;4;
18;Nordland;1853;Evenes;0000;Hele kommunen;1047;198;596;794;0;0;197;596;793;1;1;1;4;
18;Nordland;1854;Ballangen;0000;Hele kommunen;1986;354;1028;1382;0;0;353;1059;1412;1;1;1;5;
18;Nordland;1856;Røst;0000;Hele kommunen;438;89;210;299;0;0;87;210;297;2;2;0;0;
18;Nordland;1857;Værøy;0000;Hele kommunen;521;121;242;363;0;0;121;242;363;0;0;1;3;
18;Nordland;1859;Flakstad;0000;Hele kommunen;1031;162;534;696;0;0;162;536;698;1;1;1;2;
18;Nordland;1860;Vestvågøy;0000;Hele kommunen;8014;1757;3907;5664;3;24;1753;3905;5658;7;9;6;17;
18;Nordland;1865;Vågan;0000;Hele kommunen;6671;1561;3182;4743;0;0;1562;3172;4734;7;7;3;20;
18;Nordland;1866;Hadsel;0000;Hele kommunen;6042;1328;3027;4355;0;19;1247;3102;4349;2;3;6;26;
18;Nordland;1867;Bø;0000;Hele kommunen;2095;409;1103;1512;0;4;407;1103;1510;3;3;2;10;
18;Nordland;1868;Øksnes;0000;Hele kommunen;3307;819;1459;2278;1;1;803;1456;2259;3;7;6;18;
18;Nordland;1870;Sortland;0000;Hele kommunen;7383;1524;3840;5364;1;27;1523;3842;5365;1;5;6;25;
18;Nordland;1871;Andøy;0000;Hele kommunen;3755;663;2145;2808;2;9;661;2145;2806;3;8;2;11;
18;Nordland;1874;Moskenes;0000;Hele kommunen;789;154;360;514;0;0;153;362;515;3;3;0;0;
19;Troms Romsa;1902;Tromsø;0000;Hele kommunen;50737;12783;26453;39236;7;106;12770;26440;39210;11;24;83;251;
19;Troms Romsa;1903;Harstad;0000;Hele kommunen;18218;3804;9641;13445;3;35;3806;9638;13444;13;38;14;79;
19;Troms Romsa;1911;Kvæfjord;0000;Hele kommunen;2254;436;1188;1624;0;8;436;1188;1624;0;1;0;6;
19;Troms Romsa;1913;Skånland;0000;Hele kommunen;2247;370;1319;1689;0;3;369;1319;1688;1;1;3;6;
19;Troms Romsa;1917;Ibestad;0000;Hele kommunen;1142;269;567;836;0;3;267;567;834;0;0;1;4;
19;Troms Romsa;1919;Gratangen;0000;Hele kommunen;844;173;434;607;0;0;173;434;607;0;0;0;1;
19;Troms Romsa;1920;Lavangen;0000;Hele kommunen;780;141;477;618;0;0;120;496;616;0;2;2;7;
19;Troms Romsa;1922;Bardu;0000;Hele kommunen;2934;702;1556;2258;0;4;703;1558;2261;2;2;1;5;
19;Troms Romsa;1923;Salangen;0000;Hele kommunen;1654;339;890;1229;0;0;340;890;1230;0;0;0;7;
19;Troms Romsa;1924;Målselv;0000;Hele kommunen;5054;764;2885;3649;0;6;759;2885;3644;4;4;8;22;
19;Troms Romsa;1925;Sørreisa;0000;Hele kommunen;2529;444;1458;1902;1;9;444;1458;1902;0;0;2;8;
19;Troms Romsa;1926;Dyrøy;0000;Hele kommunen;949;215;520;735;0;1;214;520;734;1;1;0;1;
19;Troms Romsa;1927;Tranøy;0000;Hele kommunen;1171;233;647;880;1;1;233;648;881;0;0;1;1;
19;Troms Romsa;1928;Torsken;0000;Hele kommunen;689;154;366;520;0;0;154;366;520;0;0;1;2;
19;Troms Romsa;1929;Berg;0000;Hele kommunen;686;154;358;512;0;2;155;357;512;1;1;0;0;
19;Troms Romsa;1931;Lenvik;0000;Hele kommunen;8299;1696;4164;5860;3;26;1695;4164;5859;9;9;3;16;
19;Troms Romsa;1933;Balsfjord;0000;Hele kommunen;4303;541;2569;3110;0;9;541;2570;3111;0;2;8;20;
19;Troms Romsa;1936;Karlsøy;0000;Hele kommunen;1784;334;917;1251;1;5;297;957;1254;0;1;1;4;
19;Troms Romsa;1938;Lyngen;0000;Hele kommunen;2327;492;1222;1714;0;9;492;1222;1714;0;1;0;4;
19;Troms Romsa;1939;Storfjord;0000;Hele kommunen;1435;211;877;1088;0;2;219;869;1088;0;0;2;11;
19;Troms Romsa;1940;Gáivuotna Kåfjord;0000;Hele kommunen;1754;198;1036;1234;0;1;199;1035;1234;0;0;1;4;
19;Troms Romsa;1941;Skjervøy;0000;Hele kommunen;2145;370;1116;1486;0;5;377;1117;1494;0;8;1;8;
19;Troms Romsa;1942;Nordreisa;0000;Hele kommunen;3691;720;1880;2600;1;12;720;1881;2601;0;1;5;17;
19;Troms Romsa;1943;Kvænangen;0000;Hele kommunen;986;237;461;698;0;4;240;458;698;0;0;6;6;
20;Finnmark Finnmárku;2002;Vardø;0000;Hele kommunen;1606;293;876;1169;0;0;301;855;1156;5;12;3;11;
20;Finnmark Finnmárku;2003;Vadsø;0000;Hele kommunen;4284;855;2420;3275;0;11;855;2421;3276;2;8;12;29;
20;Finnmark Finnmárku;2004;Hammerfest;0000;Hele kommunen;7031;2557;2429;4986;1;6;2562;2430;4992;1;9;32;54;
20;Finnmark Finnmárku;2011;Guovdageaidnu Kautokeino;0000;Hele kommunen;2193;621;840;1461;0;4;619;841;1460;4;4;7;18;
20;Finnmark Finnmárku;2012;Alta;0000;Hele kommunen;13683;4569;5086;9655;0;18;4564;5099;9663;4;8;31;63;
20;Finnmark Finnmárku;2014;Loppa;0000;Hele kommunen;802;168;404;572;1;1;168;404;572;1;1;2;2;
20;Finnmark Finnmárku;2015;Hasvik;0000;Hele kommunen;682;126;355;481;0;0;126;355;481;0;1;0;2;
20;Finnmark Finnmárku;2017;Kvalsund;0000;Hele kommunen;826;157;426;583;0;0;157;426;583;1;1;0;4;
20;Finnmark Finnmárku;2018;Måsøy;0000;Hele kommunen;904;230;370;600;0;1;229;370;599;0;0;2;8;
20;Finnmark Finnmárku;2019;Nordkapp;0000;Hele kommunen;2340;531;1102;1633;0;0;527;1101;1628;4;5;4;6;
20;Finnmark Finnmárku;2020;Porsanger Porsángu Porsanki;0000;Hele kommunen;3037;683;1465;2148;0;26;684;1464;2148;1;4;3;10;
20;Finnmark Finnmárku;2021;Kárásjohka Karasjok;0000;Hele kommunen;2036;412;1005;1417;0;0;411;995;1406;5;6;3;17;
20;Finnmark Finnmárku;2022;Lebesby;0000;Hele kommunen;951;162;522;684;0;0;162;519;681;0;3;3;6;
20;Finnmark Finnmárku;2023;Gamvik;0000;Hele kommunen;736;147;359;506;0;0;144;367;511;4;4;1;3;
20;Finnmark Finnmárku;2024;Berlevåg;0000;Hele kommunen;776;139;386;525;0;0;139;387;526;2;5;2;7;
20;Finnmark Finnmárku;2025;Deatnu Tana;0000;Hele kommunen;2162;429;1186;1615;0;12;428;1184;1612;1;2;7;9;
20;Finnmark Finnmárku;2027;Unjárga Nesseby;0000;Hele kommunen;703;195;317;512;0;0;201;317;518;0;0;2;4;
20;Finnmark Finnmárku;2028;Båtsfjord;0000;Hele kommunen;1406;277;708;985;0;2;277;705;982;1;4;1;9;
20;Finnmark Finnmárku;2030;Sør-Varanger;0000;Hele kommunen;7152;1536;3668;5204;0;0;1523;3632;5155;11;17;5;28;
